21674,1217219214,2008-07-28T11:26:54-07:00,The tennis ball haircut,705,6ttui,553,offbeat,152,1217244414,401,58,christopheles,,
13810,1221583262,2008-09-16T23:41:02-07:00,Library Parking Garage [PIC],487,71vwb,431,offbeat,56,1221608462,375,65,lovemorgul,,
1085,1221620460,2008-09-17T10:01:00.783453-07:00,Accurate pie chart [ PIC ],3036,71z9i,2561,pics,475,1221645660,2086,143,,,
21906,1226835810,2008-11-16T18:43:30-07:00,EHarmony Rejection: What do you like most in a woman?,3128,7ds5s,2730,funny,398,1226861010,2332,318,googletrickedme,,
21236,1227545062,2008-11-24T23:44:22-07:00,Shuttle Mission [PIC],175,7fidh,151,space,24,1227570262,127,21,chris789,,
12685,1228176791,2008-12-02T07:13:11-07:00,Thats when it gets crazy,2571,7gvcx,2085,WTF,486,1228201991,1599,423,Raisins,,
8130,1228388232,2008-12-04T17:57:12-07:00,What happens when a person falls in love with her creation?,518,7hh3w,413,funny,105,1228413432,308,79,lilmul123,,
9656,1228794169,2008-12-09T10:42:49-07:00,"A message from US auto makers: You wont buy our shitty cars, so ... [pic]",3978,7idp5,3413,pics,565,1228819369,2848,444,kickme444,,
6678,1229417836,2008-12-16T15:57:16-07:00,The decline of Civilization [Pic],2893,7jxym,2470,pics,423,1229443036,2047,267,swampsparrow,,
7104,1229826415,2008-12-21T09:26:55-07:00,Standards: Slot Machines vs. Electronic Voting Machines,2215,7kwws,2048,pics,167,1229851615,1881,146,Grimalkin,,
3177,1230905009,2009-01-02T21:03:29.546565-07:00,A map of all the undersea internet cables in the world,333,7n2sq,293,geek,40,1230930209,253,68,chakalakasp,,
25323,1231550389,2009-01-10T08:19:49-07:00,Teenage Relationship Advice [PIC],3336,7orpi,2607,funny,729,1231575589,1878,320,mrcarson2,,
12157,1232075640,2009-01-16T10:14:00-07:00,It turns out the computer is a homo's devil machine afterall (PIC),311,7q92o,258,atheism,53,1232100840,205,104,celticagent,,
269,1233167244,2009-01-29T01:27:24-07:00,Fire/Fire in Zero Gravity,195,7taa5,176,space,19,1233192444,157,16,,,
2188,1234306384,2009-02-11T05:53:04-07:00,15 year old Calvin and Hobbes strip with almost clairvoyance on how we got into our current financial crisis.,4610,7wjrq,3635,reddit.com,975,1234331584,2660,345,spez,,
2031,1236486183,2009-03-08T11:23:03-07:00,Still think polar bears are cute? [PIC],3234,831i6,2606,pics,628,1236511383,1978,474,tylerdee,,
24052,1238340425,2009-03-29T22:27:05-07:00,Your new desktop background - ISS backdropped by the void of space and the thin line of Earth's atmosphere,216,88i60,170,space,46,1238365625,124,40,Mithridates,,
533,1238500321,2009-03-31T18:52:01-07:00,"When I do have a child, I WILL teach my baby how to do this. Best baby trick ever! [PIC]",3366,891mr,2476,funny,890,1238525521,1586,244,knarf,,
11487,1239619371,2009-04-13T17:42:51-07:00,"Holy shit, we're small [Pic]",3436,8c90f,2580,pics,856,1239644571,1724,568,kingjames128,,
2719,1239680871,2009-04-14T10:47:51-07:00,Opposite day [pic],4084,8cg3b,2837,funny,1247,1239706071,1590,444,kamaloo,,
16430,1241867939,2009-05-09T18:18:59-07:00,You left your lights on... [pic],1753,8j8nt,1374,offbeat,379,1241893139,995,254,TheSnowLeper,,
20724,1242101729,2009-05-12T11:15:29-07:00,404 error [pic],3437,8jwox,2543,funny,894,1242126929,1649,111,ElGaucho56,,
3954,1242113603,2009-05-12T14:33:23-07:00,Poor || Rich [pic],3232,8jydf,2485,pics,747,1242138803,1738,656,sonar1,,
22264,1242213613,2009-05-13T18:20:13-07:00,The Look On Neil Armstrong's Face After First Lunar Landing [PIC],266,8kaui,226,space,40,1242238813,186,57,nzeeshan,,
15301,1245660006,2009-06-22T15:40:06.481011-07:00,Vegan?,6708,8upu8,5395,pics,1313,1245685206,4082,1356,frogmander,,
3549,1247781754,2009-07-17T05:02:34-07:00,"From left to right: Han Solo, Darth Vader, Chewbacca, Leia, Luke Skywalker and R2D2",5218,922gu,4383,pics,835,1247806954,3548,705,hummir,,
3175,1248178519,2009-07-21T19:15:19-07:00,How Twilight should have ended... [pic],5195,93csk,4160,pics,1035,1248203719,3125,537,ARS_,,
4056,1248940455,2009-07-30T14:54:15-07:00,Wilt Chamberlain and Andre the Giant -- holding up Arnold Schwarzenegger (on the set of Conan)! [PIC],4298,964y8,3588,pics,710,1248965655,2878,395,jburkert,,
3008,1249962461,2009-08-11T10:47:41-07:00,I stood here for a while this morning; nothing happened.,6429,99nfu,5400,pics,1029,1249987661,4371,354,david76,,
9405,1250184743,2009-08-14T00:32:23-07:00,"Hey Reddit, Here's a totally badass picture of Mark Twain in Nikola Tesla's lab. Happy Friday.",3232,9ajxj,2585,reddit.com,647,1250209943,1938,209,spez,,
2102,1250572236,2009-08-18T12:10:36-07:00,When you reach max level...You stop leveling.,7968,9btvn,6566,pics,1402,1250597436,5164,467,Facepuncher,,
13349,1251579147,2009-08-30T03:52:27.415648-07:00,&quot;Home taping is killing record industry profits!&quot; [pic],5651,9fjma,4645,pics,1006,1251604347,3639,371,antico,,
10457,1252091384,2009-09-05T02:09:44.736580-07:00,Our Future (gif),3281,9hk4b,2412,WTF,869,1252116584,1543,536,,,
18376,1252824517,2009-09-13T13:48:37-07:00,I made an Obama poster and wanted to share it with you reddit,9258,9k64z,6613,funny,2645,1252849717,3968,897,WTFRAWL,,
106,1253089726,2009-09-16T15:28:46-07:00,What NOT to do while a soon to be famous picture of the President is being taken.,5455,9l9rq,4155,reddit.com,1300,1253114926,2855,905,spez,,
12258,1253963397,2009-09-26T18:09:57-07:00,"Then, there's Denny [Pic]",8105,9oflc,6187,funny,1918,1253988597,4269,697,swampsparrow,,
5170,1254434798,2009-10-02T05:06:38-07:00,Optical illusion [pic],8022,9q5vm,6136,pics,1886,1254459998,4250,574,kartoffelheinz,,
25303,1255049138,2009-10-09T07:45:38-07:00,It took me entirely too long to figure out what was wrong with this photo.,6059,9sfqr,4543,pics,1516,1255074338,3027,590,roland19d,,
8653,1255704515,2009-10-16T21:48:35-07:00,LETTUCE!!!1!!!!1! [PIC],789,9ux7s,545,pics,244,1255729715,301,64,ratedhero,,
5457,1256015950,2009-10-20T12:19:10-07:00,CSI: Modern computer technology at its best.,6663,9vzvc,4984,funny,1679,1256041150,3305,563,DeadBent,,
10359,1256519831,2009-10-26T08:17:11-07:00,Leviticus also said 'No Hair Cuts' but I guess we are skipping that one. [PIC],2270,9xvwe,1761,atheism,509,1256545031,1252,233,vxsarin,,
2722,1256621844,2009-10-27T12:37:24-07:00,You are to assume the role of a Chinese immigrant in 1870... [PIC],4685,9ycx7,3514,pics,1171,1256647044,2343,762,fojji,,
12157,1259037203,2009-11-24T11:33:23-07:00,Destroy the Computer!! (pic),1478,a7ri1,1010,geek,468,1259062403,542,134,olbeefy,,
356,1259411653,2009-11-28T19:34:13-07:00,Rob wants to give you a high five! GET READY!,621,a936t,430,pics,191,1259436853,239,37,thatsnomoon,,
4431,1259865455,2009-12-04T01:37:35-07:00,Sharks with people teeth [PIC],4901,aazo4,3421,pics,1480,1259890655,1941,280,bloodrobots,,
1364,1260256774,2009-12-08T14:19:34-07:00,If I had one hour to live...,7055,aciw7,5134,funny,1921,1260281974,3213,383,sameolpimp,,
2639,1260600885,2009-12-12T13:54:45-07:00,Remember the best toy of 2002 for girls?,1130,ae0dc,817,offbeat,313,1260626085,504,116,RyVal,,
279,1260797861,2009-12-14T20:37:41-07:00,"Oh, yeah.",5198,aeqn5,3516,WTF,1682,1260823061,1834,398,Winnjawn,,
5404,1260857796,2009-12-15T13:16:36-07:00,Morgan Freeman chain of command [pic],8564,af1b4,6433,pics,2131,1260882996,4302,475,igor420,,
14854,1261149681,2009-12-18T22:21:21-07:00,"Girl rats out her sister, sister posts girl's 'hook-up' list to facebook while tagging all those on the list",9917,agduh,6900,pics,3017,1261174881,3883,1702,Kuonji,,
16430,1261349838,2009-12-21T05:57:18-07:00,I hope it brightens your day to know that the whole world isn't full of dishonest people,1716,ah20r,1263,offbeat,453,1261375038,810,177,McVader,,
10209,1261816620,2009-12-26T15:37:00.984137-07:00,Atheism has led to the greatest forms of cruelty! [Pic],1501,airxd,1195,atheism,306,1261841820,889,126,Ash09,,
17562,1262163884,2009-12-30T16:04:44.490564-07:00,Give-A-Fuck-O-Meter (gif),1135,ak1zt,821,pics,314,1262189084,507,82,renderrobot,,
5456,1262488778,2010-01-03T10:19:38.545567-07:00,Guess which one the Bible's OK with? [pic],1912,al3ix,1514,atheism,398,1262513978,1116,195,Ash09,,
3260,1262584024,2010-01-04T12:47:04.906545-07:00,"Quick, take the shot before -- (sigh) damnit.",7318,alht7,5481,funny,1837,1262609224,3644,339,DonMasta,,
302,1262829212,2010-01-07T08:53:32-07:00,Here's a picture I took from my plane a couple years ago that I thought y'all might like.,4643,amqf6,3464,pics,1179,1262854412,2285,548,Chairboy,,
7842,1263036483,2010-01-09T18:28:03-07:00,You know you aren't the first ....,4585,anowb,3160,pics,1425,1263061683,1735,680,siddharthvader,,
6408,1263716533,2010-01-17T15:22:13-07:00,Owl in flight,5807,aqrnc,4609,pics,1198,1263741733,3411,428,sandhouse,,
3209,1263727568,2010-01-17T18:26:08-07:00,"Lets not lie, who else's weekend is exactly like this?",6290,aqt4n,4402,funny,1888,1263752768,2514,750,lolocoster,,
7554,1264180850,2010-01-23T00:20:50.378555-07:00,rain &amp; cloud seen from a plane [pic],3190,at636,2499,pics,691,1264206050,1808,152,zxn0,,
750,1264247175,2010-01-23T18:46:15-07:00,14 out of 14 people found this review helpful (PIC),7993,atewe,6009,funny,1984,1264272375,4025,352,nevona,,
11680,1264331959,2010-01-24T18:19:19.120764-07:00,Why vampires hate the Crucifix?,1704,atp05,1423,atheism,281,1264357159,1142,60,Ash09,,
8030,1264477221,2010-01-26T10:40:21-07:00,"1998: Lucas sent this to Cameron, when Titanic dethroned Star Wars at the box-office",7024,auerx,5537,pics,1487,1264502421,4050,430,toefer,,
7444,1265037316,2010-02-01T22:15:16-07:00,"Reddit, I'm going back to school...(pic)",3143,awyt6,2200,WTF,943,1265062516,1257,279,orsonscott,,
23992,1265156978,2010-02-03T07:29:38-07:00,I wouldn't be smiling either...,5294,axkn1,3703,pics,1591,1265182178,2112,445,BoobsRPleasant,,
19587,1265207566,2010-02-03T21:32:46-07:00,Just because it was good once doesn't mean it can't be good again,9247,axuj6,6068,pics,3179,1265232766,2889,562,jellyfishes,,
841,1265247702,2010-02-04T08:41:42-07:00,"My friend posted this as his new Facebook profile pic yesterday. He's lost 22 friends, so far.",2328,ay1ql,1817,atheism,511,1265272902,1306,491,Higgs-Bosun,,
23994,1265467218,2010-02-06T21:40:18-07:00,Best Use of Mac Genie Effect. EVER.,3826,az0pl,2731,funny,1095,1265492418,1636,145,FriesWithThat,,
15936,1265470883,2010-02-06T22:41:23-07:00,Put this as your Facebook picture and see what happens,6220,az13r,4190,reddit.com,2030,1265496083,2160,887,spez,,
16088,1265547116,2010-02-07T19:51:56-07:00,OMG This is so gooOOOAAAH! [Gif],3941,azacb,2714,funny,1227,1265572316,1487,193,Acidictadpole,,
18035,1265693031,2010-02-09T12:23:51-07:00,Dear soda-machine restocker:,1408,b01he,986,offbeat,422,1265718231,564,157,krispykrackers,,
9827,1265858745,2010-02-11T10:25:45-07:00,Endeavor launch (pic),666,b0wsx,549,space,117,1265883945,432,63,colloquy,,
16153,1265972829,2010-02-12T18:07:09-07:00,The life [PIC],4096,b1hpj,2938,pics,1158,1265998029,1780,226,zielzoeken,,
7462,1266484599,2010-02-18T16:16:39-07:00,"Years from now when our children ask us, &quot;What did we do after 9/11?&quot; we shall explain it to them using this...",6354,b3sx8,4414,politics,1940,1266509799,2474,572,spez,,
18223,1266890708,2010-02-23T09:05:08-07:00,Epic dog. It was his birthday.,8899,b5i9v,6115,pics,2784,1266915908,3331,697,neoneo185,,
13658,1267045362,2010-02-25T04:02:42.629462-07:00,You are here.,1614,b6btq,1271,atheism,343,1267070562,928,62,fault_6,,
356,1267168087,2010-02-26T14:08:07-07:00,Rob wants to give you a high five...,559,b6yyq,388,pics,171,1267193287,217,34,KeepJerseyDirty,,
19239,1267797863,2010-03-05T21:04:23-07:00,TIL how sewing machines work,1285,b9wdk,1004,todayilearned,281,1267823063,723,88,,,
18604,1268361023,2010-03-12T09:30:23.022572-07:00,Does anyone else do &quot;The Tuck&quot;?,12096,bcl8m,8636,pics,3460,1268386223,5176,1841,Ban_,,
20219,1268553083,2010-03-14T14:51:23-07:00,You make me touch your hands for stupid reasons,1425,bdcgo,996,offbeat,429,1268578283,567,144,,,
132,1268735349,2010-03-16T17:29:09-07:00,What if it's a big hoax?,6618,beaeu,4725,pics,1893,1268760549,2832,860,andrewinmelbourne,,
5111,1269390911,2010-03-24T07:35:11-07:00,Fuck wasps,9502,bhl8d,6737,pics,2765,1269416111,3972,1604,Krishna987,,
13235,1269434899,2010-03-24T19:48:19-07:00,I am Skeleton Jelly.,5763,bhv8h,3943,WTF,1820,1269460099,2123,630,nitrousconsumed,,
1851,1269452044,2010-03-25T00:34:04-07:00,Why the hell didn't I ever think of this,8492,bhyjd,6114,pics,2378,1269477244,3736,611,Redpin,,
6331,1269517861,2010-03-25T18:51:01-07:00,Best picture of a dog getting hit in the crotch with a tennis ball you will see all day. Yup that's my dog.,7641,bicy4,5632,pics,2009,1269543061,3623,494,DangerNGrayce,,
2727,1270360302,2010-04-04T12:51:42-07:00,Awwwwwww yeeeeeeee muffin,6356,bmdcn,4078,funny,2278,1270385502,1800,270,mcancill,,
3056,1270428221,2010-04-05T07:43:41-07:00,Thou hast been flamed [pic],1412,bmocx,927,offbeat,485,1270453421,442,58,krispykrackers,,
2680,1270448499,2010-04-05T13:21:39-07:00,I wonder if they were able to save this Klan man's life.,65,bmsy0,40,pics,25,1270473699,15,9,McGuffin,,
19568,1270751008,2010-04-09T01:23:28.713742-07:00,Dead Jew Child,764,bojt6,467,WTF,297,1270776208,170,247,reddit_top,,
10177,1271046438,2010-04-12T11:27:18-07:00,If elephants had no trunks and no ears...,1745,bpwqs,1143,offbeat,602,1271071638,541,84,Nelstone,,
18855,1271107775,2010-04-13T04:29:35-07:00,"If you had a portal gun, would you...?",4558,bq8nc,3000,gaming,1558,1271132975,1442,871,deepbrown,,
12714,1271595318,2010-04-18T19:55:18-07:00,Taylor Swift's Promise,7781,bsuxr,4592,reddit.com,3189,1271620518,1403,727,spez,,
5298,1272362956,2010-04-27T17:09:16-07:00,The best engine...,5126,bwzi0,3307,funny,1819,1272388156,1488,259,seyseyj,,
21171,1272448192,2010-04-28T16:49:52-07:00,"While coding at work today I heard a loud crash, looking outside revealed this...",9787,bxhqs,6285,pics,3502,1272473392,2783,1172,Destos,,
1913,1272502051,2010-04-29T07:47:31-07:00,"Fuck you, Flowers [pic]",5554,bxv8b,3500,funny,2054,1272527251,1446,211,weisenzahn,,
4696,1272752732,2010-05-02T05:25:32-07:00,Tripping balls [GIF],6184,bz16u,3951,funny,2233,1272777932,1718,566,hookahey,,
15375,1272868475,2010-05-03T13:34:35-07:00,probably the best self-pic i have seen (SFW),5769,bzkkt,3851,pics,1918,1272893675,1933,270,glasnostic,,
6987,1273409772,2010-05-09T19:56:12-07:00,"Hah, Mr. FreeClimber, you'll never get past that handhold, it's too-- (⊙▃⊙)",3614,c1xpf,2354,WTF,1260,1273434972,1094,296,DarthContinent,,
6329,1274332050,2010-05-20T12:07:30-07:00,Winner?,16714,c6evn,9628,pics,7086,1274357250,2542,717,desolo,,
5294,1274398061,2010-05-21T06:27:41-07:00,I contend we are both atheists...,2411,c6oie,1746,atheism,665,1274423261,1081,238,Remdawg,,
3612,1274841816,2010-05-26T09:43:36-07:00,How LOST should have ended,7156,c8cbe,4493,pics,2663,1274867016,1830,474,DrJulianBashir,,
19604,1274875243,2010-05-26T19:00:43-07:00,"Meanwhile, in Japan... [sfw]",6408,c8iit,4094,pics,2314,1274900443,1780,673,phantomfigure,,
11380,1274927286,2010-05-27T09:28:06.238672-07:00,Next Generation Unreal,3745,c8q6q,2545,gaming,1200,1274952486,1345,957,Pinecone,,
13379,1275088238,2010-05-29T06:10:38-07:00,What would you do if you could stop time? [NSFW],5044,c9d1y,3081,WTF,1963,1275113438,1118,348,S1N4N,,
19266,1275504363,2010-06-03T01:46:03-07:00,"inspiration from bruce lee, that is all.",8777,cay7i,5637,pics,3140,1275529563,2497,833,Wormsy,,
25636,1275564041,2010-06-03T18:20:41-07:00,*gulp* Stuffed Friend [comic],3594,cb8n2,2463,pics,1131,1275589241,1332,625,,,
13889,1275603720,2010-06-04T05:22:00-07:00,"Remember, when attaching a Space Shuttle to its 747 carrier aircraft, always...",785,cbe1w,572,space,213,1275628920,359,65,TheLoneHoot,,
25557,1275709329,2010-06-05T10:42:09-07:00,If there were one good reason to do meth...this is it,1170,cbt40,758,pics,412,1275734529,346,115,EatingTheRoad,,
16900,1276134053,2010-06-10T08:40:53-07:00,"There's fan art, and then there's just WTF",7283,cdkts,4533,WTF,2750,1276159253,1783,502,Undergroundpyro,,
10253,1276996953,2010-06-20T08:22:33-07:00,Rossi [GIF],6169,ch0wf,3903,funny,2266,1277022153,1637,336,hookahey,,
12139,1277097326,2010-06-21T12:15:26-07:00,And So the Work Week Begins...,1534,chfvd,968,pics,566,1277122526,402,81,thingamarob,,
841,1277530249,2010-06-26T12:30:49-07:00,"Stormfront members, this is for you.",3266,cjc4k,2270,atheism,996,1277555449,1274,404,KorgRue,,
24877,1278143318,2010-07-03T14:48:38-07:00,The girls at the Grammys,19,clq4z,16,katyperry,3,1278168518,13,0,foltaggio,,
9585,1278422179,2010-07-06T20:16:19-07:00,"I was just hanging out in the backyard, about to mow the lawn, when a monarch butterfly flew over and landed on my finger.",593,cmq6m,361,pics,232,1278447379,129,54,missstar,,
7388,1278557464,2010-07-08T09:51:04-07:00,This is professional photobombing,8003,cncjo,5026,pics,2977,1278582664,2049,286,,,
8742,1278619809,2010-07-09T03:10:09-07:00,WWI simplified,5706,cnn6z,3655,funny,2051,1278645009,1604,816,Libra30,,
5799,1279218691,2010-07-16T01:31:31-07:00,Don't trust anyone you meet online. You could regret it.,2123,cq7w1,1376,geek,747,1279243891,629,115,mmofan,,
18748,1279910175,2010-07-24T01:36:15-07:00,blghblghblghblghblglhblg,1662,ct6d4,1078,offbeat,584,1279935375,494,80,caligula213,,
3049,1280219609,2010-07-27T15:33:29-07:00,Chewbacca riding a giant squirrel fighting Nazi's in the mountains (pic),700,cueqx,445,pics,255,1280244809,190,48,EthicalReasoning,,
10491,1280799348,2010-08-03T08:35:48-07:00,Action News: Redditor's house raided!,7433,cwvgj,4607,pics,2826,1280824548,1781,381,manbro2000,,
11728,1281941977,2010-08-16T13:59:37-07:00,Sad photo or saddest photo?,9392,d1v6c,5819,pics,3573,1281967177,2246,435,grossgirl,,
16409,1282015782,2010-08-17T10:29:42-07:00,Escher's Impossible Cube,2347,d27ss,1678,offbeat,669,1282040982,1009,226,SLDeviant,,
14133,1282451619,2010-08-22T11:33:39-07:00,Just Flip A Coin,8062,d44rr,5030,pics,3032,1282476819,1998,415,peanutsfan1995,,
13849,1282561999,2010-08-23T18:13:19.083196-07:00,Electron microscope image of a maggot.,4375,d4nb1,2972,WTF,1403,1282587199,1569,632,Wogan121,,
16313,1282640369,2010-08-24T15:59:29-07:00,abcdefghijklmnopqrstuvwxyz,3638,d51do,2413,offbeat,1225,1282665569,1188,206,shatteredverve,,
11281,1283064931,2010-08-29T13:55:31-07:00,You gonna light that pipe?,4844,d6yfy,3197,funny,1647,1283090131,1550,244,Lufthavn,,
8589,1283228190,2010-08-31T11:16:30-07:00,The Neti Pot [Gif],715,d7tet,477,pics,238,1283253390,239,211,ThePwnStick,,
847,1283244009,2010-08-31T15:40:09.502308-07:00,Cicada Molting [gif],1755,d7x88,1245,offbeat,510,1283269209,735,148,draftz,,
5916,1283358984,2010-09-01T23:36:24-07:00,"Can't beat tha-- Wait, what?",6700,d8kom,4304,funny,2396,1283384184,1908,450,mellowmonk,,
21148,1283391527,2010-09-02T08:38:47-07:00,"Your move, captcha...",12498,d8q2x,7774,funny,4724,1283416727,3050,458,slimjuvie,,
9864,1283841577,2010-09-07T13:39:37-07:00,Then and Now (pic),22155,daryq,13228,pics,8927,1283866777,4301,721,EthicalReasoning,,
16825,1283937335,2010-09-08T16:15:35-07:00,I love gravity [NSFW],4411,dbc3w,2937,pics,1474,1283962535,1463,283,PureLife,,
16825,1283944450,2010-09-08T18:14:10-07:00,Dropped (nsfw),128,dbdiy,111,gif,17,1283969650,94,7,dfweyer,,
14774,1284010347,2010-09-09T12:32:27-07:00,... in bed.,6243,dbqik,4041,funny,2202,1284035547,1839,249,cranktheguy,,
9023,1284359039,2010-09-13T13:23:59-07:00,&quot;If I had two bullets...&quot;,11016,ddctj,6828,funny,4188,1284384239,2640,473,mammals,,
11784,1284425059,2010-09-14T07:44:19.465049-07:00,Spotted in the children's section of a Reject Shop [PIC],9891,ddpb8,6390,WTF,3501,1284450259,2889,419,dhaadh,,
15515,1284721595,2010-09-17T18:06:35-07:00,Ghetto Swimming Pool (PIC),6298,dfgp8,4073,WTF,2225,1284746795,1848,366,geotagger,,
13748,1284957446,2010-09-20T11:37:26.742175-07:00,Pure Laziness.,11470,dgh38,7220,WTF,4250,1284982646,2970,410,Estoye,,
607,1285015764,2010-09-21T03:49:24-07:00,Happy 60th birthday to the legend that is Bill Murray!,9111,dgse5,5799,pics,3312,1285040964,2487,439,barksmith,,
8579,1285363070,2010-09-25T04:17:50-07:00,WTF! odd animated gif...,6023,dipmk,3769,WTF,2254,1285388270,1515,181,donfuxx,,
8562,1285585225,2010-09-27T18:00:25-07:00,TIL that giant salamanders exist.,918,djr7i,792,todayilearned,126,1285610425,666,146,belzner,,
3119,1285647759,2010-09-28T11:22:39-07:00,Finally... a way to carry my iPad around while drinking a coffee and not look like a douche [pic],11934,dk44c,7787,funny,4147,1285672959,3640,585,NotYourMothersDildo,,
15164,1285676195,2010-09-28T19:16:35-07:00,I must eat this. A nearly extinct type of strawberry is now being marketed in Europe. It is white in color and has deep-set red seeds. It tastes like a pineaple... so they call it a Pineberry. [pic],8245,dkame,5088,pics,3157,1285701395,1931,703,theamehzingsam,,
2974,1285846195,2010-09-30T18:29:55-07:00,Unexpected problems [pic],11204,dlac8,6737,funny,4467,1285871395,2270,210,,,
12938,1286018601,2010-10-02T18:23:21-07:00,C-C-C-Combo Breaker! [GIF],8880,dm2gh,5472,funny,3408,1286043801,2064,302,milkkore,,
23058,1286217160,2010-10-05T01:32:40-07:00,Math Teacher Fail.,16147,dn08l,9812,pics,6335,1286242360,3477,1967,caligula213,,
22742,1286362524,2010-10-06T17:55:24-07:00,Uphands,15764,dnu1z,9002,pics,6762,1286387724,2240,557,Silzer,,
17418,1286373200,2010-10-06T20:53:20-07:00,Frankie Burn,8996,dnw9r,5629,funny,3367,1286398400,2262,1027,andrewinmelbourne,,
22523,1286495891,2010-10-08T06:58:11-07:00,"....And you will know my name is Lord Vader!, When I lay my vengeance upon thee.",2177,dok0h,1414,geek,763,1286521091,651,126,nortel,,
7104,1286742273,2010-10-11T03:24:33-07:00,Las Vegas Slots vs Electronic Voting Machines,9638,dpnhz,6071,politics,3567,1286767473,2504,535,spez,,
17072,1286897480,2010-10-12T22:31:20-07:00,This picture reminded me why I loved Star Wars so much.,1530,dqjh1,1025,geek,505,1286922680,520,94,FudgieATX,,
14385,1287188262,2010-10-16T07:17:42.159957-07:00,I almost killed my family this morning making pancakes. I think it's time Walmart put some variety in their labels.,14456,ds1tn,8984,reddit.com,5472,1287213462,3512,1391,spez,,
10529,1287397776,2010-10-18T17:29:36.383000-07:00,Astronauts hang out at the...,10094,dt2r2,6065,pics,4029,1287422976,2036,291,RocketRobinhood,,
10112,1287417287,2010-10-18T22:54:47-07:00,dog,19021,dt6rb,11152,pics,7869,1287442487,3283,1267,,,
9634,1287497916,2010-10-19T21:18:36-07:00,"Truly incredible, I say.",11225,dtobw,6850,pics,4375,1287523116,2475,673,Doctor_Watson,,
5150,1287585546,2010-10-20T21:39:06-07:00,Oh physicists.,9015,du7oc,5470,funny,3545,1287610746,1925,478,lahwran0,,
7683,1287695868,2010-10-22T04:17:48-07:00,Serving The Queen [PIC],9630,duu7y,5658,funny,3972,1287721068,1686,361,Mattho,,
1123,1287891639,2010-10-24T10:40:39-07:00,Epic Windows 98 Logon,10876,dvpgk,6280,funny,4596,1287916839,1684,685,dudewithpants,,
6254,1288096399,2010-10-26T19:33:19-07:00,The anti Facebook.,8976,dwy5j,5187,funny,3789,1288121599,1398,447,KaptainKarmel,,
15666,1288152701,2010-10-27T11:11:41-07:00,Is it worth it?,10636,dxahh,6362,pics,4274,1288177901,2088,1364,SkinnyLove1,,
2885,1288508010,2010-10-31T13:53:30.588238-07:00,I don't know how I should feel about this,6782,dz6yl,4254,pics,2528,1288533210,1726,259,,,
909,1288544914,2010-11-01T00:08:34-07:00,This is all kinds of not ok...,7693,dzdzh,4584,WTF,3109,1288570114,1475,405,draynen,,
20250,1288649079,2010-11-02T05:04:39-07:00,What do we want? (rally sign),8291,e0010,5367,pics,2924,1288674279,2443,201,cobrophy,,
11309,1288654465,2010-11-02T06:34:25-07:00,Police Notes,9687,e015f,5976,funny,3711,1288679665,2265,324,rktfuel,,
10289,1288794846,2010-11-03T21:34:06.902782-07:00,It would be funny if it weren't to tragic.,8318,e105m,5247,atheism,3071,1288820046,2176,673,,,
9509,1288892780,2010-11-05T00:46:20-07:00,UPS delivery procedure. (source?),8331,e1lq1,5105,funny,3226,1288917980,1879,697,zero000,,
8167,1289251839,2010-11-09T04:30:39-07:00,"If this actually makes sense, I'm out 35 picohitlers",9887,e3ewv,5784,WTF,4103,1289277039,1681,524,ryugan,,
964,1289271866,2010-11-09T10:04:26-07:00,Carl on Duty,14765,e3jnx,8172,Black Cops,6593,1289297066,1579,501,warium,,
10016,1289310134,2010-11-09T20:42:14-07:00,Someone has adapted nicely to being FOREVER ALONE. [pic],12082,e3u6f,6923,pics,5159,1289335334,1764,720,PenName,,
90,1289311077,2010-11-09T20:57:57.933837-07:00,Stop singing already! [GIF],9352,e3ue8,5527,funny,3825,1289336277,1702,304,milkkore,,
6527,1289382479,2010-11-10T16:47:59-07:00,"I made another map. This time it's of the world, and I hope it is offensive to every single one of you.",22489,e4b0t,12345,pics,10144,1289407679,2201,2496,subtonix,,
5848,1289447466,2010-11-11T10:51:06-07:00,This man might be the most badass man that has ever lived.,17626,e4opj,9932,funny,7694,1289472666,2238,953,ikana89,,
19984,1289472068,2010-11-11T17:41:08-07:00,What about Norway? (IMG),481,e4vjk,324,atheism,157,1289497268,167,100,doGtsopeR,,
15361,1289495730,2010-11-12T00:15:30-07:00,Battleshots,8170,e50os,4898,pics,3272,1289520930,1626,397,j1mtones,,
12545,1289517995,2010-11-12T06:26:35-07:00,Destination - How to get there [pic],2932,e53yt,1748,offbeat,1184,1289543195,564,174,,,
19079,1289910597,2010-11-16T19:29:57-07:00,Am I the only one that wanted this screensaver to be an actual game when I was a kid?,9377,e7ar0,5435,gaming,3942,1289935797,1493,708,echoscreen,,
5879,1290089954,2010-11-18T21:19:14-07:00,TIL the continents can be rearranged to form a chicken,6458,e8h6z,3975,todayilearned,2483,1290115154,1492,346,amoeba_incognito,,
1986,1290107618,2010-11-19T02:13:38-07:00,You're bringing back...the memories.,256,e8klm,207,gifs,49,1290132818,158,10,I_RAPE_CATS,,
20871,1290129893,2010-11-19T08:24:53-07:00,Murphy's Law in full effect,294,e8oh9,278,gifs,16,1290155093,262,10,belladonnadiorama,,
16981,1290600862,2010-11-24T19:14:22-07:00,How to get hit by a car like a boss.,14183,ebfe0,8104,funny,6079,1290626062,2025,395,blazemaster,,
11164,1290782315,2010-11-26T21:38:35-07:00,How to draw an owl,1093,eccj2,634,funny,459,1290807515,175,38,radonchong,,
828,1290821166,2010-11-27T08:26:06-07:00,What most /r/gaming threads boil down to,6320,echm6,3716,gaming,2604,1290846366,1112,345,lolocoster,,
4868,1291006774,2010-11-29T11:59:34.372404-07:00,"Whoa,, Police brutality just took it to A-whole-Natha-level",10366,edgg3,6079,WTF,4287,1291031974,1792,1409,,,
4385,1291125545,2010-11-30T20:59:05-07:00,A young Stephen Colbert,12036,eeahf,6918,pics,5118,1291150745,1800,878,likepeterose,,
9983,1291176731,2010-12-01T11:12:11-07:00,This is Ninja.,1945,eemb6,1114,funny,831,1291201931,283,91,ironsoul,,
25216,1291307480,2010-12-02T23:31:20-07:00,The ultimate in Parental Trolling - Frogdad,9639,efgra,5688,funny,3951,1291332680,1737,404,Heaps_Flacid,,
18247,1291440898,2010-12-04T12:34:58-07:00,"Dear Mr. Haberny... Sincerely, Cash4Gold",29723,eg83m,16753,pics,12970,1291466098,3783,950,tobiasgreenich,,
3,1291627919,2010-12-06T16:31:59-07:00,What a pro.,221,ehb1z,188,gifs,33,1291653119,155,13,I_RAPE_CATS,,
17229,1292209368,2010-12-13T10:02:48-07:00,"How to insult LOTR, Star Wars &amp; Harry Potter Fanboys with a single image",4244,el38i,2572,geek,1672,1292234568,900,182,mr_fusion,,
15538,1292642846,2010-12-18T10:27:26-07:00,&quot;I know origami.&quot; &quot;...show me.&quot; [Matrix],186,enyu1,165,gifs,21,1292668046,144,3,bajandy,,
20663,1292643527,2010-12-18T10:38:47.174156-07:00,"After photoshopping this, I wondered what I have been doing with my life.",12303,enyz4,6996,WTF,5307,1292668727,1689,497,RuiningPunSubThreads,,
16527,1292683032,2010-12-18T22:37:12-08:00,"u mad, brain?",330,eo82z,311,gifs,19,1292711832,292,19,bajandy,,
9646,1292990433,2010-12-22T11:00:33-07:00,Me and my mom 1981-Now,28433,epz2k,15267,pics,13166,1293015633,2101,1475,idointernet,,
11747,1293016546,2010-12-22T18:15:46-07:00,"Damn, It Feels Good to Be a Gangster: The Desktop Edition",942,eq6n1,618,geek,324,1293041746,294,54,Fremenguy,,
19675,1293068900,2010-12-23T08:48:20-07:00,Science Fail followed by Science Win,19402,eqh61,10797,pics,8605,1293094100,2192,1488,JavaLSU,,
4517,1293429761,2010-12-27T13:02:41-07:00,To whoever keeps this street free of snow... I'm impressed,9075,es6qs,5461,pics,3614,1293454961,1847,577,Cromax,,
17005,1293558297,2010-12-29T00:44:57-07:00,TIL the Easter Island statues are actually complete torsos.,3052,eszcd,2071,todayilearned,981,1293583497,1090,184,crowhurst,,
16524,1293572681,2010-12-29T04:44:41-07:00,Once again the Saints prove their worth!,14148,et1s0,8020,pics,6128,1293597881,1892,729,lilylauren,,
18287,1293713485,2010-12-30T19:51:25-07:00,What Happens When I Am Confronted By A Pretty Girl [GIF],1131,etz0f,681,funny,450,1293738685,231,46,microwave_safe_bowl,,
6244,1293732562,2010-12-31T02:09:22-08:00,Cap'n Lincoln,3732,eu474,2396,pics,1336,1293761362,1060,168,cherna71,,
